S   ############################
   #  #  #     #              #
#  #  #  ####  #  ####  #  ####
#           #     #     #     #
##########  ####  ##########  #
#                          #  #
#  ####  ##########  ##########
#  #           #  #           #
#  #######  #  #  ##########  #
#     #     #     #  #     #E #
####  ####  #  ####  ####  #  #
#        #  #  #  #           #
#  #############  #  ####  ####
#  #  #  #  #     #     #     #
#  #  #  #  #  ####  #######  #
#        #  #           #     #
#######  #  #######  ####  #  #
#           #  #  #  #  #  #  #
##########  #  #  #  #  ####  #
#           #        #        
############################  