    ############################
   #  #  #     #              #
#  #  #  ####  #  ####  #  ####
#           #     #     #     #
##########  ####  ##########  #
#                          #  #
#  ####  ##########  ##########
#  #           #  #           #
#  #######  #  #  ##########  #
#     #     #     #  #     #  #
####  ####  #  ####  ####  #  #
#        #  #  #  #           #
#  #############  #  ####  ####
#  #  #  #  #     #     #     #
#  #  #  #  #  ####  #######  #
#        #  #   S       #     #
#######  #  #######  ####  #  #
#           #  #  #  #  #  #  #
##########  #  #  #  #  ####  #
#    E       #        #        
############################  